###############
#.............#
#.####........#
#.#..#........#
#.#..#........#
#.####........#
#.............#
##########....#
#........#....#
#........#....#
#........#....#
#........#....#
#........#....#
#.............#
#.............#
#........#....#
#........#....#
#........#....#
#........#....#
##########....#
#.............#
#.............#
#.............#
#.............#
###############